11111111111111111111111111111111111111111
111111111100000000PC11110010000000C101111
10000000000000000111111110010000000C10011
10000000000111111110000000000C10010001111
1000000000000000000C10010010000000C101111
100000001111110000000C10C10010000000C1111
100000001111111111110000000000C1001000111
10000001111110000000C10010010000000C11111
100000011111110000000C10C10010000000C1111
100000011111110000000C10C10010000000C1111
100000000000000000000000111110000000C0011
111111111111111111111111110000000C100C111
1CCCCCCCCCCCCCCCCCCCCCCCCCCCCC000CCCCCC11
111111111111111111111111111110000000C0011
111111111111111111111111110000000C100C111
111111111111111111111111110000000C100C101
1111111111111111111111111110000000C100C11
1E000000000000000000000000000000000000001
10000000000000000000000000000000000000001
11111001111100100001111111100100001110111
11111111111111111111111111111111111111111