111111111111
0010000000C1
000011111001
P0011E000001
111111111111